amh	Amharic
ara	Arabic
ben	Bengali
bho	Bhojpuri
cmn	Mandarin Chinese
deu	German
eng	English
fra	French
guj	Gujarati
hau	Hausa
hin	Hindi
ind	Indonesian
ita	Italian
jav	Javanese
jpn	Japanese
kan	Kannada
kor	Korean
mar	Marathi
mya	Burmese
nld	Dutch
pes	Persian
pnb	Punjabi (Western)
por	Portuguese
rus	Russian
spa	Spanish
swh	Swahili
tam	Tamil
tel	Telugu
tgl	Tagalog
tha	Thai
tuk	Turkmen
tur	Turkish
ukr	Ukrainian
urd	Urdu
vie	Vietnamese
yor	Yoruba
zsm	Malay
